0000000000000000000000000000000000000000000000000000000000000000000000000000000000000000000000000000000000000000000000000000000S0000F0000000000000000000000000000000000S0000F0000000000000000000000000000000000000000000000000000000000000000000000000000000000000000000000000000000000000000000000000000000
0000000000000000000000000000000000000000000000000000000000000000000000000000000000000000000000000000000000000S0S0000000000000000000000000000000000000F0000000000000000000B000000000000000000000F0000000000000000000B0000000000000000000000000000000000000000000000000000000000000000000000000000000000000000
000000000000000000000000000000000000000000000000000000000000000000000000000000000000000000000000000000000000B000000000000000000BSB00000000000000000B00FF000000000000000BSB000000000000000000B000000000000000000000000000000000000000000000000000000000000000000000000000000000000000000000000000000000000000
00000000000000000000000000000000000000000000000000000000000000000000000000000000000000000000000000000000000000000000000000000000SFFB0000000000000000S00000000000000000000000000000000000000000B0000000000000000000000000000000000000000000000000000000000000000000000000000000000000000000000000000000000000
00000000000000000000000000000000000000000000000000000000000000000000000000000000000000000000000000000000000000000000000000000000000F0000000000000000SSB00000000000000000000F00000000000000000000000000000000000000000000000000000000000000000000000000000000000000000000000000000000000000000000000000000000
0000000000000000000000000000000000000000000000000000000000000000000000000000000000000000000000000000000000000000000000000000000000BB00000000000000000FSB0000000000000000BBF00000000000000000SB00000000000000000000000000000000000000000000000000000000000000000000000000000000000000000000000000000000000000
000000000000000000000000000000000000000000000000000000000000000000000000000000000000000000000000000000000000000000000000000000000L0000000000000000SS0L0FF0000000000000000L0000000000000000000000000000000000000000000000000000000000000000000000000000000000000000000000000000000000000000000000000000000000
00000000000000000000000000000000000000000000000000000000000000000000000000000000000000000000000000000000000L0L00000000000000000LSL00000000000000000LBL0F0000000000000000S00F000000000000000000B0000000000000000000000000000000000000000000000000000000000000000000000000000000000000000000000000000000000000
0000000000000000000000000000000000000000000000000000000000000000000000000000000000000000000000000000000000000000000000000000000LL00B00000000000000LFFS0SL00000000000000LL00B00000000000000000000000000000000000000000000000000000000000000000000000000000000000000000000000000000000000000000000000000000000
0000000000000000000000000000000000000000000000000000000000000000000000000000000000000000000000000000000000000LL00000000000000000B0FL0000000000000000LSS0000000000000000LFBB000000000000000000000000000000000000000000000000000000000000000000000000000000000000000000000000000000000000000000000000000000000
00000000000000000000000000000000000000000000000000000000000000000000000000000000000000000000000000000000000000000000000000000000000000000000000000FLSBBSLF00000000000000000000000000000000000000000000000000000000000000000000000000000000000000000000000000000000000000000000000000000000000000000000000000
0000000000000000000000000000000000000000000000000000000000000000000000000000000000000000000000000000000000000LL00000000000000000LF0L00000000000000000B000000000000000000LFSS00000000000000000B00000000000000000000LL0000000000000000000000000000000000000000000000000000000000000000000000000000000000000000
000000000000000000000000000000000000000000000000000000000000000000000000000000000000000000000000000000000000BBB0000000000000000BS00B000000000000000BS0I0B000000000000000BB00B0000000000000000BFFB00000000000000000BB0000000000000000000000000000000000000000000000000000000000000000000000000000000000000000
000000000000000000000000000000000000000000000000000000000000000000000000000000000000000000000000000000000000BB00000000000000000BSSBB000000000000000BI0FFB00000000000000B00BB0000000000000000BB00000000000000000000000000000000000000000000000000000000000000000000000000000000000000000000000000000000000000
0000000000000000000000000000000000000000000000000000000000000000000000000000000000000000000000000000000000000000000000000000000BB00FB0000000000000BSSIIIB00000000000000BB00FB0000000000000000000000000000000000000000000000000000000000000000000000000000000000000000000000000000000000000000000000000000000
00000000000000000000000000000000000000000000000000000000000000000000000000000000000000000000000000000000000000000000000000000000B0IF000000000000000LSSIIL000000000000000B0IF00000000000000000000000000000000000000000000000000000000000000000000000000000000000000000000000000000000000000000000000000000000
00000000000000000000000000000000000000000000000000000000000000000000000000000000000000BLLLLLLLB0000000000BS000L000SB000000000B0I00L00I0B000000000B00I0L0I00B000000000L00I0L0I00L0000000000B000L000B000000000000B0F0F0B00000000000000LLLLL0000000000000000000000000000000000000000000000000000000000000000000
00000000000000000000000000000000000000000000000000000000000000000000000000000000000000000000000000000000000000000000000000000000S00000000000000000000IF000000000000000000FI00000000000000000000S000000000000000000000000000000000000000000000000000000000000000000000000000000000000000000000000000000000000
0000000000000000000000000000000000000000000000000000000000000000000000000000000000000000000000000000000000000BSB0000000000000000BIIIB000000000000000FI0IF000000000000000BIIIB0000000000000000BSB000000000000000000000000000000000000000000000000000000000000000000000000000000000000000000000000000000000000
000000000000000000000000000000000000000000000000000000000000000000000000000000000000000000000000000000000000000000000000000000000II00000000000000000IIFL0000000000000000IFLS00000000000000000LS0000000000000000000000000000000000000000000000000000000000000000000000000000000000000000000000000000000000000
00000000000000000000000000000000000000000000000000000000000000000000BB00000000000000000L00B0000000000000000L00FL000000000000000L0ISB000000000000000LLIB0000000000000000L0ISB000000000000000L00FL000000000000000L00B00000000000000000BB0000000000000000000000000000000000000000000000000000000000000000000000
0000000000000000000000000000000000000000000000000000000000000000000LLLLLLL000000000000LS000000L00000000000L0I0I0I0L00000000000L0I0I0I0L00000000000L000000FL000000000000LLLLLLL000000000000LS00L000000000000000L0I0L000000000000000L00FL0000000000000000LLL00000000000000000000000000000000000000000000000000
0000000000000000000000000000000000000000000000000000000000000000000000000000000000000000LBLBL00000000000000L0FLF0L0000000000000L00I00L0000000000000L0BLB0L0000000000000L0III0L0000000000000L0SIS0L00000000000000LLLLL000000000000000000000000000000000000000000000000000000000000000000000000000000000000000
00000000000000000000000000000000000000000000000000000000000000000000000000000000000000000L000000000000000000B0LL000000000000000B000FB00000000000000SSIII000000000000000B000FB000000000000000B0LL00000000000000000L000000000000000000000000000000000000000000000000000000000000000000000000000000000000000000
0000000000000000000000000000000000000000000000000000000000000000000LL0L0LL000000000000L00B0B00L00000000000L0I000I0L000000000000B0LFL0B00000000000000SIIIS00000000000000B0LFL0B000000000000L0I000I0L00000000000L00B0B00L000000000000LL0L0LL000000000000000000000000000000000000000000000000000000000000000000
00000000000000000000000000000000000000000000000000000000000000000000000000000000000000000000000000000000000LLLLL00000000000000L0SPS0L00000000000000LLLLL00000000000000L0FPF0L00000000000000LLLLL000000000000000000000000000000000000000000000000000000000000000000000000000000000000000000000000000000000000
0000000000000000000000000000000000000000000000000000000000000000000000000000000000000000LLLL000000000000000BS0SPB000000000000000LLLL00000000000000000000000000000000000LLLLL00000000000000BFF00PB00000000000000LLLLL0000000000000000000000000000000000000000000000000000000000000000000000000000000000000000
000000000000000000000000000000000000000000000000000000000000000000000000000000000000000000000000000000000000BBB00000000000000000SBP00000000000000000FBF00000000000000000PBS00000000000000000BBB0000000000000000000000000000000000000000000000000000000000000000000000000000000000000000000000000000000000000
000000000000000000000000000000000000000000000000000000000000000000000000000000000000000000000000000000000000S00F0000000000000000000000000000000000000PP000000000000000000SF000000000000000000000000000000000000000000000000000000000000000000000000000000000000000000000000000000000000000000000000000000000
0000000000000000000000000000000000000000000000000000000000000000000000000000000000000000000000000000000000000LL00000000000000000LFFL000000000000000LSP0L000000000000000LS0PL0000000000000000LLL0000000000000000000000000000000000000000000000000000000000000000000000000000000000000000000000000000000000000
000000000000000000000000000000000000000000000000000000000000000000000000000000000000000000000000000000000000BFB0000000000000000B0P0B000000000000000BS0SB000000000000000B0P0B0000000000000000BFB0000000000000000000000000000000000000000000000000000000000000000000000000000000000000000000000000000000000000
00000000000000000000000000000000000000000000000000000000000000000000000000000000000000000B000000000000000000B0LL0000000000000000B0S0L000000000000000FPIPF000000000000000B0S0L000000000000000B0LL00000000000000000B000000000000000000000000000000000000000000000000000000000000000000000000000000000000000000
00000000000000000000000000000000000000000000000000000000000000000000000000000000000000000L000000000000000000BSLL00000000000000L0S00PL000000000000000LILB00000000000000L0F00PL000000000000000BFLL00000000000000000L000000000000000000000000000000000000000000000000000000000000000000000000000000000000000000
00000000000000000000000000000000000000000000000000000000000000000000000000000000000000000L000000000000000000B0B00000000000000000SPS00000000000000000LPL00000000000000000LFL00000000000000000LFL000000000000000000L000000000000000000000000000000000000000000000000000000000000000000000000000000000000000000
000000000000000000000000000000000000000000000000000000000000000000000000000000000000000000000000000000000000LSL0000000000000000L0SPL0000000000000000FI00000000000000000L0PFL0000000000000000L0L0000000000000000000000000000000000000000000000000000000000000000000000000000000000000000000000000000000000000
0000000000000000000000000000000000000000000000000000000000000000000000000000000000000000L000000000000000000B0L00000000000000000LF0B0L0000000000000LP0BPSSL0000000000000LF0B0L00000000000000B0L000000000000000000L0000000000000000000000000000000000000000000000000000000000000000000000000000000000000000000
0000000000000000000000000000000000000000000000000000000000000000000000000000000000000000000000000000000000000000000000000000000LLLLLL0000000000000LS0R00FL000000000000LS0R00FL0000000000000LLLLLL00000000000000000000000000000000000000000000000000000000000000000000000000000000000000000000000000000000000
0000000000000000000000000000000000000000000000000000000000000000000000000000000000000000000000000000000000000000000000000000000LLLL000000000000000LS0FRBLL000000000000LS0000FRB000000000000LLLLLLL0000000000000000000000000000000000000000000000000000000000000000000000000000000000000000000000000000000000
00000000000000000000000000000000000000000000000000000000000000000000000000000000000000000000000000000000000000000000000000000000LLLL000000000000000L0FSRL00000000000000LFBS0RL00000000000000L0LLB00000000000000000000000000000000000000000000000000000000000000000000000000000000000000000000000000000000000
000000000000000000000000000000000000000000000000000000000000000000000000000000000000000000000000000000000000L0L000000000000000LB000LL0000000000000SS0R0FFB000000000000LB000LL000000000000000L0L0000000000000000000000000000000000000000000000000000000000000000000000000000000000000000000000000000000000000
000000000000000000000000000000000000000000000000000000000000000000000000000000000000000000000000000000000000000000000000000000LLL0000000000000000LSFS0T0FL000000000000LLL00000000000000000000000000000000000000000000000000000000000000000000000000000000000000000000000000000000000000000000000000000000000
00000000000000000000000000000000000000000000000000000000000000000000000000000000000000000000000000000000000000LLL0000000000000000BF00L000000000000S0SIIT0L000000000000000BF00L0000000000000000LLL00000000000000000000000000000000000000000000000000000000000000000000000000000000000000000000000000000000000
0000000000000000000000000000000000000000000000000000000000000000000000000000000000000000000000000000000000000LLL0000000000000000L0T0L00000000000000L0TIT0L000000000000LFTIIITFL000000000000L00S00L0000000000000000S00000000000000000000000000000000000000000000000000000000000000000000000000000000000000000
00000000000000000000000000000000000000000000000000000000000000000000000000000000000000000000000000000000000LLLLLL0000000000000LS0+00FB0000000000000LLLLLL0000000000000LS00=0FB0000000000000LLLLLL00000000000000000000000000000000000000000000000000000000000000000000000000000000000000000000000000000000000
00000000000000000000000000000000000000000000000000000000000000000000000000000000000000000000000000000000000LLLLLL0000000000000+S00-0FB0000000000000LLLLLL0000000000000-S0=00FB0000000000000LLLLLL00000000000000000000000000000000000000000000000000000000000000000000000000000000000000000000000000000000000
00000000000000000000000000000000000000000000000000000000000000000000000000000000000000000000000000000000000LLLLLLL000000000000LS0+0+0FB000000000000LLLLLLL000000000000LS0=0_0FB000000000000LLLLLLL0000000000000000000000000000000000000000000000000000000000000000000000000000000000000000000000000000000000
00000000000000000000000000000000000000000000000000000000000000000000000000000000000000000000000000000000000BBBBB00000000000000BS0K0FB00000000000000BBBBB00000000000000BS0K0FB00000000000000BBBBB000000000000000000000000000000000000000000000000000000000000000000000000000000000000000000000000000000000000
000000000000000000000000000000000000000000000000000000000000000000000000000000000000000000000000000000000000000000000000000000LLLLLLL000000000000LSS0K0FFL000000000000LLLLLLL0000000000000000000000000000000000000000000000000000000000000000000000000000000000000000000000000000000000000000000000000000000
0000000000000000000000000000000000000000000000000000000000000000000000000000000000000000000000000000000000000LLL0000000000000000L00FB00000000000000SS0K0L000000000000000L00FB0000000000000000LLL000000000000000000000000000000000000000000000000000000000000000000000000000000000000000000000000000000000000
000000000000000000000000000000000000000000000000000000000000000000000000000000000000000000000000000000000000B0B000000000000000LBBSBBL000000000000L0F0K0F0L000000000000LBBSBBL000000000000000B0B0000000000000000000000000000000000000000000000000000000000000000000000000000000000000000000000000000000000000
00000000000000000000000000000000000000000000000000000000000000000000000000000000000000000000000000000000000LLLLL00000000000000LS0K00L000000000000LPF0I0FPL000000000000LS0000L00000000000000LLLLL000000000000000000000000000000000000000000000000000000000000000000000000000000000000000000000000000000000000
000000000000000000000000000000000000000000000000000000000000000000000LLL0000000000000000L000L000000000000000L0B0L00000000000000L0F0F0L0000000000000B0L0L0B0000000000000BB0S0BB000000000000L000S000L000000000000LL000LL000000000000000LLL00000000000000000000000000000000000000000000000000000000000000000000
0000000000000000000000000000000000000000000000LLLLL00000000000000L00000LL000000000000L00LB0IFLL0000000000LIIIIII000L000000000LS0I0IPILIL000000000L00ILB0ILIL000000000LS0I0IPILIL000000000LIIIIII000L000000000L00LB0IFLL0000000000L00000LL0000000000000LLLLL0000000000000000000000000000000000000000000000000
00000000000000000000000000000000000000000000000000000000000000000000000B0B000000000000LLLLL0B000000000000B00000L0L00000000000L0LLB0L0L00000000000L00S00B0L00000000000LFL0L0LFL000000000000B0S00L0L0000000000000LLL0L0L000000000000L000000B0000000000000LLBLLL00000000000000000000000000000000000000000000000
000000000000000000000000000000000000000000000000000000000000000000BBB0BBB000000000000BRFRBR00B00000000000BSIIIII0B00000000000BRIIIIIRB000000000000BIILIIB000000000000BRIIIIIRB00000000000B0IIIIIFB00000000000B00RBRSRB000000000000BBB0BBB0000000000000000000000000000000000000000000000000000000000000000000